4GLD	FXGL	EUR
BTP	FBTP	EUR
BTS	FBTS	EUR
DAX	FDAX	EUR
DAXKI	FDXD	EUR
DDAX	FDIV	EUR
DESX5	FEX1	EUR
DIVDAX	FDVD	EUR
DJ200	FMCP	EUR
DJ200L	FLCP	EUR
DJ200S	FSCP	EUR
DJ600	FXXP	EUR
DJES	FXXE	EUR
DJESL	FLCE	EUR
DJESM	FMCE	EUR
DJESS	FSCE	EUR
DJSD	FD3D	EUR
EO1	FEO1	EUR
ESA	FESA	EUR
ESE	FESE	EUR
ESF	FESF	EUR
ESI	FESI	EUR
ESM	FESM	EUR
ESTX50	FESX	EUR
ESU	FESU	EUR
EU3	FEU3	EUR
EUN2	EUNF	EUR
EXS1	EXSF	EUR
GBL	FGBL	EUR
GBM	FGBM	EUR
GBS	FGBS	EUR
GBX	FGBX	EUR
GTI	FGTI	EUR
MDAX	F2MX	EUR
MXRU	FMXR	USD
STX	FSTX	EUR
SX3E	FESO	EUR
SX3P	FSTO	EUR
SX4E	FESC	EUR
SX4P	FSTC	EUR
SX6P	FSTU	EUR
SX7E	FESB	EUR
SX7P	FSTB	EUR
SX86P	FSTL	EUR
SX8E	FESY	EUR
SX8P	FSTY	EUR
SXAP	FSTA	EUR
SXDE	FESH	EUR
SXDP	FSTH	EUR
SXEP	FSTE	EUR
SXFP	FSTF	EUR
SXIP	FSTI	EUR
SXKE	FEST	EUR
SXKP	FSTT	EUR
SXMP	FSTM	EUR
SXNE	FESG	EUR
SXNP	FSTG	EUR
SXOP	FSTN	EUR
SXPE	FESS	EUR
SXPP	FSTS	EUR
SXQE	FESZ	EUR
SXQP	FSTZ	EUR
SXRE	FESR	EUR
SXRP	FSTR	EUR
SXTE	FESV	EUR
SXTP	FSTV	EUR
TDX	FTDX	EUR
V2TX	FVS	EUR
XAGUSD	FSFX	USD
XAUUSD	FGFX	USD
