GVZ	GV	USD	cfe
VIX	VX	USD	cfe
VM	VM	USD	cfe
VT	VT	USD	cfe
BTP	FBTP	EUR	dtb	HMUZ
BTS	FBTS	EUR	dtb	HMUZ
DAX	FDAX	EUR	dtb	HMUZ
ESTX50	FESX	EUR	dtb	HMUZ
GBL	FGBL	EUR	dtb	HMUZ
GBM	FGBM	EUR	dtb	HMUZ
GBS	FGBS	EUR	dtb	HMUZ
GBX	FGBX	EUR	dtb	HMUZ
MDAX	F2MX	EUR	dtb	HMUZ
STX	FSTX	EUR	dtb	HMUZ
TDX	FTDX	EUR	dtb	HMUZ
7I	7I	USD	ecbot
AC	EH	USD	ecbot
AIGCI	AW	USD	ecbot
DD	DD	USD	ecbot
I3	I3	USD	ecbot
INDU	ZD	USD	ecbot
SA	SA	USD	ecbot
SR	SR	USD	ecbot
T2	T2	USD	ecbot
T5	T5	USD	ecbot
TN	TN	USD	ecbot
YC	XC	USD	ecbot
YK	XK	USD	ecbot
YW	XW	USD	ecbot
Z3N	Z3N	USD	ecbot
ZC	ZC	USD	ecbot
ZL	ZL	USD	ecbot
ZM	ZM	USD	ecbot
ZO	ZO	USD	ecbot
ZQ	ZQ	USD	ecbot
ZR	ZR	USD	ecbot
ZS	ZS	USD	ecbot
ZW	ZW	USD	ecbot
UB	UB	USD	ecbot	HMUZ
YM	YM	USD	ecbot	HMUZ
ZB	ZB	USD	ecbot	HMUZ
ZF	ZF	USD	ecbot	HMUZ
ZN	ZN	USD	ecbot	HMUZ
ZT	ZT	USD	ecbot	HMUZ
16E	16E	USD	globex	FGHJKMNQUVXZ
36E	36E	USD	globex	HMUZ
AJY	AJY	JPY	globex	HMUZ
BOS	BOS	USD	globex
BQX	BIO	USD	globex	HMUZ
CB	CB	USD	globex	FGHJKMNQUVXZ	CB	CME
CHI	CHI	USD	globex
CUS	CUS	USD	globex
CZK	CZK	USD	globex	HMUZ
DA	DC	USD	globex	FGHJKMNQUVXZ	DC	CME
DEN	DEN	USD	globex
DY	DY	USD	globex	FGHJKMNQUVXZ	DY	CME
EED	EED	USD	globex
EM	GLB	USD	globex
GDK	GDK	USD	globex	FGHJKMNQUVXZ	DK	CME
GE	GE	USD	globex
GF	GF	USD	globex	FHJKQUVX
GSCI	GD	USD	globex	FGHJKMNQUVXZ
GTB	GTB	USD	globex
HE	HE	USD	globex
HUF	HUF	USD	globex	HMUZ
ILS	ILS	USD	globex	HMUZ
IXB	XAB	USD	globex
IXE	XAE	USD	globex
IXI	XAI	USD	globex
IXM	XAF	USD	globex
IXR	XAP	USD	globex
IXT	XAK	USD	globex
IXU	XAU	USD	globex
IXV	XAV	USD	globex
IXY	XAY	USD	globex
J7	J7	USD	globex	HMUZ
JPY	6J	USD	globex	HMUZ
KRW	KRW	USD	globex	HMUZ
LAV	LAV	USD	globex
LAX	LAX	USD	globex
LB	LBS	USD	globex
LE	LE	USD	globex
MCD	MCD	USD	globex	HMUZ
MIA	MIA	USD	globex
MID	MD	USD	globex
MJY	MJY	USD	globex	HMUZ
MNCA	MNF	USD	globex
MNEA	EMF	USD	globex
MSF	MSF	USD	globex	HMUZ
NDX	ND	USD	globex
NIY	NIY	JPY	globex
NKD	NKD	USD	globex
NOK	NOK	USD	globex	HMUZ
NYM	NYM	USD	globex
PJY	PJY	JPY	globex	HMUZ
PLN	PLN	USD	globex	HMUZ
RMB	RMB	USD	globex	HMUZ
RMY	RMY	JPY	globex	HMUZ
RP	RP	GBP	globex	HMUZ
RUR	6R	USD	globex	HMUZ
RY	RY	JPY	globex	HMUZ
SDG	SDG	USD	globex
SEK	SEK	USD	globex	HMUZ
SEY	EJ	JPY	globex
SFR	SFR	USD	globex
SGX	SG	USD	globex
SJY	SJY	JPY	globex	HMUZ
SMC	SMC	USD	globex
SML	SMP	USD	globex
SPX	SP	USD	globex
SVX	SU	USD	globex
WDC	WDC	USD	globex
ZAR	6Z	USD	globex	HMUZ
ACD	ACD	CAD	globex	HMUZ
AUD	6A	USD	globex	HMUZ
BRE	6L	USD	globex	HMUZ
CAD	6C	USD	globex	HMUZ
CHF	6S	USD	globex	HMUZ
CJY	CJY	JPY	globex	HMUZ
E7	E7	USD	globex	HMUZ
EAD	EAD	AUD	globex	HMUZ
ECD	ECD	CAD	globex	HMUZ
ECK	ECK	EUR	globex	HMUZ
EHF	EHF	EUR	globex	HMUZ
EMD	EMD	USD	globex	HMUZ
EPZ	EPZ	EUR	globex	HMUZ
ES	ES	USD	globex	HMUZ
EUR	6E	USD	globex	HMUZ
GBP	6B	USD	globex	HMUZ
M6A	M6A	USD	globex	HMUZ
M6B	M6B	USD	globex	HMUZ
M6C	M6C	CAD	globex	HMUZ
M6E	M6E	USD	globex	HMUZ
M6J	M6J	JPY	globex	HMUZ
M6S	M6S	CHF	globex	HMUZ
MXP	6M	USD	globex	HMUZ
NQ	NQ	USD	globex	HMUZ
NZD	6N	USD	globex	HMUZ
PSF	PSF	CHF	globex	HMUZ
RF	RF	CHF	globex	HMUZ
RME	RME	EUR	globex	HMUZ
COIL	COIL	USD	ipe
GOIL	GOIL	USD	ipe
HOIL	HOIL	USD	ipe
NGF	NGF	GBP	ipe
RBOB	RBOB	USD	ipe
WTI	WTI	USD	ipe
ED	ED	USD	liffe
F1DV	XZ	GBP	liffe
G	G	GBP	liffe
H	H	GBP	liffe
I	I	EUR	liffe
L	L	GBP	liffe
O	O	EUR	liffe
P	P	EUR	liffe
Q	Q	EUR	liffe
S	S	CHF	liffe
TWS	TWS	EUR	liffe
USO	USO	USD	liffe
USP	USP	USD	liffe
USW	USW	USD	liffe
Y	Y	GBP	liffe
Z	Z	GBP	liffe
R	R	GBP	liffe	HMUZ
CC	CC	USD	nybot
CI	CI	USD	nybot
CRY	CR	USD	nybot
CT	CT	USD	nybot
KC	KC	USD	nybot
OJ	OJ	USD	nybot
RLG	RG	USD	nybot
RLV	RV	USD	nybot
RYO	RF	USD	nybot
SB	SB	USD	nybot
SF	SF	USD	nybot
DX	DX	USD	nybot	HMUZ
TF	TF	USD	nybot	HMUZ
6Q	XSN	USD	nymex
BB	BB	USD	nymex
BZ	BZ	USD	nymex
CC	CJ	USD	nymex
CL	CL	USD	nymex
CT	TT	USD	nymex
GC	GC	USD	nymex
GVXX	GVF	USD	nymex
HG	HG	USD	nymex
HO	HO	USD	nymex
HRC	HRC	USD	nymex
KC	KT	USD	nymex
MGC	MGC	USD	nymex
NG	NG	USD	nymex
PA	PA	USD	nymex
PL	PL	USD	nymex
QC	QC	USD	nymex
QG	QG	USD	nymex
QH	QH	USD	nymex
QI	QI	USD	nymex
QM	QM	USD	nymex
QO	QO	USD	nymex
QU	QU	USD	nymex
RB	RB	USD	nymex
SB	YO	USD	nymex
SI	SI	USD	nymex
UX	UX	USD	nymex
MXEA	MFS	USD	nyseliffe
MXEF	MME	USD	nyseliffe
MXUS	MUN	USD	nyseliffe
YG	YG	USD	nyseliffe
YI	YI	USD	nyseliffe
ZG	ZG	USD	nyseliffe
ZI	ZI	USD	nyseliffe
