16E	16E	USD
36E	36E	USD
ACD	ACD	CAD
AJY	AJY	JPY
AUD	6A	USD
BOS	BOS	USD
BQX	BIO	USD
BRE	6L	USD
CAD	6C	USD
CB	CB	USD
CHF	6S	USD
CHI	CHI	USD
CJY	CJY	JPY
CUS	CUS	USD
CZK	CZK	USD
DA	DC	USD
DEN	DEN	USD
DY	DY	USD
E7	E7	USD
EAD	EAD	AUD
ECD	ECD	CAD
ECK	ECK	EUR
EED	EED	USD
EHF	EHF	EUR
EM	GLB	USD
EMD	EMD	USD
EPZ	EPZ	EUR
ES	ES	USD
EUR	6E	USD
GBP	6B	USD
GDK	GDK	USD
GE	GE	USD
GF	GF	USD
GSCI	GD	USD
GTB	GTB	USD
HE	HE	USD
HUF	HUF	USD
ILS	ILS	USD
IXB	XAB	USD
IXE	XAE	USD
IXI	XAI	USD
IXM	XAF	USD
IXR	XAP	USD
IXT	XAK	USD
IXU	XAU	USD
IXV	XAV	USD
IXY	XAY	USD
J7	J7	USD
JPY	6J	USD
KRW	KRW	USD
LAV	LAV	USD
LAX	LAX	USD
LB	LBS	USD
LE	LE	USD
M6A	M6A	USD
M6B	M6B	USD
M6C	M6C	CAD
M6E	M6E	USD
M6J	M6J	JPY
M6S	M6S	CHF
MCD	MCD	USD
MIA	MIA	USD
MID	MD	USD
MJY	MJY	USD
MNCA	MNF	USD
MNEA	EMF	USD
MSF	MSF	USD
MXP	6M	USD
NDX	ND	USD
NIY	NIY	JPY
NKD	NKD	USD
NOK	NOK	USD
NQ	NQ	USD
NYM	NYM	USD
NZD	6N	USD
PJY	PJY	JPY
PLN	PLN	USD
PSF	PSF	CHF
RF	RF	CHF
RMB	RMB	USD
RME	RME	EUR
RMY	RMY	JPY
RP	RP	GBP
RUR	6R	USD
RY	RY	JPY
SDG	SDG	USD
SEK	SEK	USD
SEY	EJ	JPY
SFR	SFR	USD
SGX	SG	USD
SJY	SJY	JPY
SMC	SMC	USD
SML	SMP	USD
SPX	SP	USD
SVX	SU	USD
WDC	WDC	USD
ZAR	6Z	USD
